12,17,
100000000001
100000000001
100000200001
100000000001
100000000001
100001100001
100000000001
100000000001
100000000001
100000000001
100000010001
100000010001
100000000001
100000000001
100000000001
100000000001
100000000001

