12,20,
110000000011
110000000011
110000000011
110000000011
110000000011
110001110011
110000000011
110000000011
110000000011
110002000011
110000000011
110000000011
110000000011
110011100011
110000000011
110000000011
110000000011
000000000000
000000000000
000000000000

