12,20,
110000000011
110000000011
110000200011
110000000011
110011110011
110011110011
110000000011
110000000011
110000000011
110000000011
110000000011
110000000011
110000000011
110000000011
110000000011
110000000011
110000000011
000000000000
000000000000
000000000000

