12,17,
100000000001
100000000001
100000200001
100000000001
100000000001
100001110001
100000000001
100000000001
100000000001
100000010001
100000010001
100000010001
100000000001
100000000001
100000000001
100000000001
100000000001

