40,30,
0000011111111111111111111111111111111111
0000011111111111111111111111111111111111
0000011111111111111111111111111111111111
0000011111111111111111111111111111111111
0000011111111111111111111111111111111111
0000010000101100000001100000001100000001
0000010000000000000000000000000000000000
0000010000000000000000000000000000000000
0000010000000000000000000000000000000000
0000000000000000000000000000000000000000
0000000000000000000000000000000000000000
0000000000000000000000000000000000000000
0000000000000000000000000000000000000000
0000011111101100000001100000001100000001
0000011111101100000001100000001100000001
0000000000000000000000000000000000000000
0000000000000000000000000000000000000000
0000000000000000000000000000000000000000
0000000000000000000000000000000000000000
0000000000000000000000000000000000000000
0000000000000000000000000000000000000000
0000000000000000000000000000000000000000
0000000000000000000000000000000000000000
0000000000000000000000000000000000000000
0000000000000000000000000000000000000000
0000000000000000000000000000000000000000
0000000000000000200000000000000000000000
0000000000000000000000000000000000000000
0000000000000000000000000000000000000000
0000000000000000000000000000000000000000
