40,50,
0000000000000000000000000000000000000000
0000000000000000000000000000000000000000
0000000000000000000000000000000000000000
0000000000000000000000000000000000000000
0000000000000000000000000000000000000000
0000011111000000000011110010000000000000
0110111111000000000111111011000000011000
1111111111000000000111111111111111111111
1111111111000000000111111111111111111111
1111111111000000000111111111111111111111
1111111111000000000111111111111111111111
1111111111000000000111111111111111111111
1111111111000000000111111111111111111111
1111111111000000000111111111111111111111
1111111111000000000111111111111111111111
1111111111000000000111111111111111111111
1111111111000000000111111111111111111111
1111111111000000000111111111111111111111
1111111111000000000111111111111111111111
1111111111000000000111111111111111111111
1111111111000000000111111111111111111111
1111111111000000000111111111111111111111
1111111111000000000111111111111111111111
1111111111000000000111111111111111111111
1111111111000000000111111111111111111111
1111111111000000000111111111111111111111
1111111111000000000111111111111111111111
1111111111000000000111111111111111111111
1111111111000000000111111111111111111111
1111111111000000000111111111111111111111
1111111111000000000111111111111111111111
1111111111000000000111111111111111111111
1111111111000000000111111111111111111111
1111111111000000000111111111111111111111
1111111111000000000111111111111111111111
0010100001000000000100000011000000011000
0000000001000000000100000000000000000000
0000000001000000000100000000000000000000
0000000001000000000100000000000000000000
0000000000000000000000000000000000000000
0000000000000020000000000000000000000000
0000000000000000000000000000000000000000
0000000000000000000000000000000000000000
0010111111000000000111110011000000011000
0010111111000000000111110011000000011000
0000000000000000000000000000000000000000
0000000000000000000000000000000000000000
0000000000000000000000000000000000000000
0000000000000000000000000000000000000000
0000000000000000000000000000000000000000
