102,100,
000000000000000000000000000000000000000000000000000000000000000000000000000000000000000000000000001111
000000000000000000000000000000000000000000000000000000000000000000000000000000000000000000000000001111
000000000000000000000000000000000000000000000000000000000000000000000000000000000000000000000000001111
000000000000000000000000000000000000000000000000000000000000000000000000000000000000000000000000001111
000000000000000000000000000000000000000000000000000000000000000000000000000000000000000000000000001111
000000000000000000000000000000000000000000000000000000000000000000000000000000000000000000000000001111
000000000000000000000000000000000000000000000000000000000000000000000000000000000000000000000000001111
110000111111111111111111111111111111111111111100001111111111111111111111111111111111111111000000000111
110000111111111111111111111111111111111111111100001111111111111111111111111111111111111111000000000111
110000111111111111111111111111111111111111111100001111111111111111111111111111111111111111000000000111
110000111111111111111111111111111111111111111100001111111111111111111111111111111111111111000000000111
110000111111111111111111111111111111111111111100001111111111111111111111111111111111111111000000000111
110000111111111111111111111111111111111111111100001111111111111111111111111111111111111111000000000111
110000111111111111111111111111111111111111111100001111111111111111111111111111111111111111000000000111
110000111111111111111111111111111111111111111100001111111111111111111111111111111111111111000000000111
110000111111111111111111111111111111111111111100001111111111111111111111111111111111111111000000000111
110000111111111111111111111111111111111111111100001111111111111111111111111111111111111111000000000111
110000111111111111111111111111111111111111111100001111111111111111111111111111111111111111000000000111
110000111111111111111111111111111111111111111100001111111111111111111111111111111111111111000000000111
110000111111111111111111111111111111111111111100001111111111111111111111111111111111111111000000000111
110000111111111111111111111111111111111111111100001111111111111111111111111111111111111111000000000111
110000111111111111111111111111111111111100000000001111111111111111111111111111111111111111000000000111
110000111111111111111111111111111111111100000000001111111111111111111111111111111111111111000000000011
110000111111111111111111111111111111111100000000001111111111000000111111111111111111111111000000000011
110000111111111111111111111111111111111100000000001111111111000000111111111111111111111111000000000011
100000011111111111111111111111111111111000000000000111111110000000111111111111111111111110000000000011
000000000000000000000000000000000000000000000000000000000000000000000000000000000000000000000000000011
000000000000000000000000000000000000000000000000000000000000000000000000000000000000000000000000000011
000000000000000000000000000000000000000000000000000000000000000000000000000000000000000000000000000011
000000000000000000000000000000000000000000000000000000000000000000000000000000000000000000000000000011
000000000000000000000000000000000000000000000000000000000000000000000000000000000000000000000000000011
000000000000000000000000000000000000000000000000000000000000000000000000000000000000000000000000000011
000000000000000000000000000000000000000000000000000000000000000000000000000000000000000000000000000011
000000000000000000000000000000000000000000000000000000000000000000000000000000000000000000000000000011
000000000000000000000000000000000000000000000000000000000000000000000000000000000000000000000000000011
000000000000000000000000000000000000000000000000000000000000000000000000000000000000000000000000000011
000000000000000000000000000000000000000000000000000000000000000000000000000000000000000000000000000011
110000111111111111111111111100000011111111111100001111111111111000000000111111111111111111000000000011
110000111111111111111111111100000111111111111100011111111111111000000000111111111111111111000000000011
110000111111111111111111111100000000000000000000000000000000000000000000111111111111111111000000000011
110000111111111111111111111100000000000000000000000000000000000000000000111111111111111111000000000011
110000111111111111111111111100000000000000000000000000000000000000000000111111111111111111000000000011
110000111111111111111111111100000000000000000000000000000000000000000000111111111111111111000000000011
110000111111111111111111111100000000000000000000000000000000000000000000111111111111111111000000000011
110000111111111111111111111100000000000000000000000000000000000000000001111111111111111111000000000011
110000111111111111111111111100000000000000000000000000000000000000000001111111111111111111000000000011
110000111111111111111111111100000000000000000000000000000000000000000001111111111111111111000000000011
110000111111111111111111111100000000000000000000000000000000000000000001111111111111111111000000000011
110000111111111111111111111100000000000000000000000000000000000000000001111111111111111111000000000011
110000111111111111111111111100000000000000000000000000000000000000000001111111111111111111000000000011
110000111111111111111111111100000000000000000000000000000000000000000001111111111111111111000000000001
110000111111111111111111111100000000000000000000000000000000000000000001111111111111111111000000000001
110000111111111111111111111100000000000000000000000000000000000000000001111111111111111111000000000001
110000111111111111111111111100000000000000000000000000000000000000000001111111111111111111000000000001
110000111111111111111111111100000000000000000000000000000000000000000001111111111111111111000000000001
100000011111111111111111110000000000000000000000000000000000000000000001111111111111111110000000000001
000000000000000000000000000000000000000000000000000000000000000000000000000000000000000000000000000001
000000000000000000000000000000000000000000000000000000000000000000000000000000000000000000000000000001
000000000000000000000000000000000000000000000000000000000000000000000000000000000000000000000000000001
000000000000000000000000000000000000000000000000000000000000000000000000000000000000000000000000000001
000000000000000000000000000000000000000000000000000000000000000000000000000000000000000000000000000001
000000000000000000000000000000000000000000000000000000000000000000000000000000000000000000000000000001
000000000000000000000000000000000000000000000000000000000000000000000000000000000000000000000000000001
000000000000000000000000000000000000000000000000000000000000000000000000000000000000000000000000000001
000000000000000000000000000000000000000000000000000000000000000000000000000000000000000000000000000001
000000000000000000000000000000000000000000000000000000000000000000000000000000000000000000000000000001
000000000000000000000000000000000000000000000000000000000000000000000000000000000000000000000000000001
100000111000000000000000000000000000000000011000001110000000000000000000000000000000000110000000000001
110000111111111111111111000011111111111111111100001111111111111111110000111111111111111111000000000001
110000111111111111111111000011111111111111111100001111111111111111110000111111111111111111000000000001
110000111111111111111111111111111111111111111100001111111111111111111111111111111111111111000000000001
110000111111111111111111111111111111111111111100001111111111111111111111111111111111111111000000000001
110000111111111111111111111111111111111111111100001111111111111111111111111111111111111111000000000001
110000111111111111111111111111111111111111111100001111111111111111111111111111111111111111000000000000
110000111111111111111111111111111111111111111100001111111111111111111111111111111111111111000000000000
110000111111111111111111111111111111111111111100001111111111111111111111111111111111111111000000000000
110000111111111111111111111111111111111111111100001111111111111111111111111111111111111111000000000000
110000111111111111111111111111111111111111111100001111111111111111111111111111111111111111000000000000
110000111111111111111111111111111111111111111100001111111111111111111111111111111111111111000000000000
110000111111111111111111111111111111111111111100001111111111111111111111111111111111111111000111111110
110000111111111111111111111111111111111111111100001111111111111111111111111111111111111111000111111110
110000111111111111111111111111111111111111111100001111111111111111111111111111111111111111000111111110
000000000000000000000000000000000000000000000000000000000000000000000000000000000000000000000111111110
000000000000000000000000000000000000000000000000000000000000000000000000000000000000000000000111111111
000000000000000000000000000000000000000000000000000000000000000000000000000000000000000000000111111111
000000000000000000000000000000000000000000000000000000000000000000000000000000000000000000000111111111
100000111000000000000000000000000000000000011000001110000000000000000000000000000000000110000111111111
000000000000000000000000000000000000000000000000000000000000000000000000000000000000000000000111111111
000000000000000000000000000000000000000000000000000000000000000000000000000000000000000000000111111111
000000000000000000000000000000000000000000000000000000000000000000000000000000000000000000000111111111
000000000000000000000000000000000000000000000000000000000000000000000000000000000000000000000111111111
000000000000000000000000000000000000000000000000000000000000000000000000000000000000000000000111111111
000000000000000000000000000000000000000000000000000000000000000000000000000000000000000000000111111111
000000000000000000000000000000000000000000000000000000000000000000000000000000000000000000000111111111
000000000000000000000000000000000000000000000000000000000000000000000000000000000000000000000111111111
000000000000000000000000000000000000000000000000000000000000000000000000000000000000000000000111111111
000000000000000000000000000000000000000000000000000000000000000000000000000000000000000000000111111111
000000000000000000000000000000000000000000000000000000000000000000000000000000000000000000000111111111
000000000000000000000000000000000000000000000000000000000000000000000000000000000000000000000111111111
000000000000000000000000000000000000000000000000000000000000000000000000000000000000000000000111111111
