50,10,
11111111111111111111111000000111111111111111111111
11000110000110000111001000000101110000011000110001
00000000000000000000000000000000000000000000000000
00000000000000000000000000000000000000000000000000
11000110000110000111111000001111110000110001100000
11000110000110000111111000001111110000110001100011
11000110000110000111111000001111110000110001100011
00000000000110000000000000000000000000000001100000
00000000000000000000000002000000000000000000000000
00000000000000000000000000000000000000000000000000

