101,21,
11111111111111111111111111111111111111111111000000000000111111111111111111111111111111111111111111111
11111111111111111111111111111111111111111111000000000000111111111111111111111111111111111111111111111
11000000001110000000001110000000011101100001000000000000100001101110000000011100000000011000000000111
10000000000100000000000100000000001001000001000000000000100001000100000000001000000000000000000000010
00000000000000000000000000000000000000000001000000000000100000000000000000000000000000000000000000000
00000000000000000000000000000000000000000001000000000000100000000000000000000000000000000000000000000
00000000000000000000000000000000000000000001000000000000100000000000000000000000000000000000000000000
00000000000000000000000000000000000000000000000000000000000000000000000000000000000000000000000000000
00000000000000000000000000000000000000000000000000000000000000000000000000000000000000000000000000000
00000000000000000000000000000000000000000000000000000000000000000000000000000000000000000000000000000
00000000000000000000000000000000000000000000000000000000000000000000000000000000000000000000000000000
00000000000000000000000000000000000000000000000000000000000000000000000000000000000000000000000000000
10000000000100000000000100000000001000111111000000000000111111000100000000001000000000000000000000010
11000000000110000000001100000000001001111111000000000000111111001100000000001100000000011000000000111
11000000000110000000001100000000001001111111000000000000111111001100000000001100000000011000000000111
00000000000000000000000000000000000000000000000000000000000000000000000000000000000000000000000000000
00000000000000000000000000000000000000000000000000000000000000000000000000000000000000000000000000000
00000000000000000000000000000000000000000000000000000000000000000000000000000000000000000000000000000
00000000000000000000000000000000000000000000000000000000000000000000000000000000000000000000000000000
00000000000000000000000000000000000000000000000000000000000000000000000000000000000000000000000000000
00000000000000000000000000000000000000000000000000000000000000000000000000000000000000000000000000000

