79,17,
0100000000001000000000000001000001000000000001000001001000000000001000000000010
0000000000000000000000000000000001000000000001000000000000000000000000000000000
0000000000000000000000000000000001000000000001000000000000000000000000000000000
0000000000000000000000000000000001000000000001000000000000000000000000000000000
0000000000000000000000000000000000000000000000000000000000000000000000000000000
0000000000000000000000000000000000000000000000000000000000000000000000000000000
0000000000000000000000000000000000000000000000000000000000000000000000000000000
0000000000000000000000000000000000000000000000000000000000000000000000000000000
0000000000000000000000000000000000000000000000000000000000000000000000000000000
0100000000001000000000000001111110000000000000111110001000000000001000000000010
1100000000001100000000011001111111000000000001111111001100000000011000000000011
1100000000001100000000011001111111000000000001111111001100000000011000000000011
0000000000000000000000000000000000000000000000000000000000000000000000000000000
0000000000000000000000000000000000000000000000000000000000000000000000000000000
0000000000000000000000000000000000000020000000000000000000000000000000000000000
0000000000000000000000000000000000000000000000000000000000000000000000000000000
0000000000000000000000000000000000000000000000000000000000000000000000000000000

