15,80,
111100110000001
111100110000001
111100110000001
111100110000001
111100000000001
111100000000001
111100111000001
111100111000001
111100000000001
111100000000001
111100000000001
111100110000001
111100110000001
111100000000001
111100000000001
111100110000001
111100110000001
111100000000001
111100000000001
111100000000001
111100110000001
111100110000001
111100000000001
111100000000001
111100111000001
111100111000001
111100000000001
111100000000001
111100000000001
111100110000001
111100110000001
111100000000001
111100000000001
111100110000001
111100110000001
111100110000001
111100110000001
111100110000001
111100110000001
111100000000001
111100000000001
111100000000001
111100110000001
111100110000001
111100110000001
111100110000001
111100110000001
111100000000001
111100000000001
111100000000001
111100111000001
111100111000001
111100000000001
111100000000001
111100000000001
111100111000001
111100000000001
111100000000001
111100000000001
111100111000001
111100111000001
111100000000001
111100000000001
111100000000001
111100111000001
111100000000001
111100000000001
111100000000001
111100110000001
111100110000001
111100000000001
111100000000001
111100000000001
111100110000001
111100000000001
111100000000001
111100000000001
111111111000001
111111111000001
111111111000001

