41,70,0.8,
10000000111111111111111111111111111111111
10000000111111111111111111111111111111111
10000000111111111111111111111111111111111
10000000111111111111111111111111111111111
10000000111111111111111111111111111111111
10000000011111111111111111111111111111111
10000000011111111111111111111111111111111
10000000011111111111111111111111111111111
10000000111111111111111111111111111111111
10000000111111111111111111111111111111111
10000000011111111111111111111111111111111
10000000011111111111111111111111111111111
10000000011111111111111111111111111111111
10000000011111111111111111111111111111111
11111101111111111111111111111111111111111
11111101111111111111111111111111111111111
11100000011111111111111111111111111111111
11100000011111111111111111111111111111111
11100000011111111111111111111111111111111
11111000011111111111111111111111111111111
11111101111111111111111111111111111111111
10000001111000000000000111111111111111111
10000000000000000000000000000000000000111
10000000000000000000000000000000000000000
10000000000000000000000000000000000000000
10000000111000000000001110000000000000000
10000000111000000000001110000000000000000
10000000000000000000000000000000000000000
10000000000000000000000000000000000000000
10000000000000000000000000000000000000000
10000000000000000000000000000000000000000
10000000111000000000001110000000000000000
10000000111000000000001110000000000000000
11111111111000000000000000000000000000000
11111111111000000000000000000000000000000
11111111111111100000000000000000000000000
11111111111111111111111110000000000000000
11111111111111111111111110000000000000000
11111111111111111111111110000000000000000
11111111111111111111111110000000000000000
11111111111111111111111110000000000000000
11111111111111111111111110000000000000000
11111111111111111111111110000000000000000
11111111111111111111000000000000000000000
11111111111111111111000000000000000000000
11111111111111111111000000000000000000000
11111111111111111111000000000000000000000
11111111111111111111111100000000000000000
11111111111111111111111100000000000000000
11111111111111111111111100000000000000000
11111111111111111111111100000000000000000
11111111111111111111111100000000000000000
11111111111111111111111100000000000000000
11111111111111111111111100000000000000000
11111111111111111111111100000000000000000
11111111111111111100000000000000000000000
11111111111111111100000000000000000000000
11111111111000000000001100000000000000000
10000000111000000000001100000000000000000
10000000000000000000001100000000000000000
10000000000000000000000000000000000000000
10000000000000000000000000000000000000000
10000000000000000000000000000000000000000
10000000110000000000011100000000000000000
10000000110000000000011100000000000000000
10000000000000000000011100000000000000000
10000000000000000000000000000000000000000
10000000000000000000000000000000000000000
10000000100000000100000000000000000000000
11111111111111111111111111111111111111111

##### comments ######
AG150827: this map is based on master29e2.txt, changed, removed:
- 15 columns front
- 13 cols end 
- 5 rows at bottom
- 
- 

