53,88,0.8,
11111111111111111111111111111111111111111111111111111
11111100000000000000011111111111111111111111111111111
11111100000000000000011111111111111111111111111111111
11111100000000000000011111111111111111111111111111111
11111100000000000000011111111111111111111111111111111
11111100000000000000011111111111111111111111111111111
11111100000000000000011111111111111111111111111111111
11111100000000000000011111111111111111111111111111111
11111100000000000000011111111111111111111111111111111
11111100000000000000011111111111111111111111111111111
11111100000000000000011111111111111111111111111111111
11111100000000000000011111111111111111111111111111111
11111100000001100000011111111111111111111111111111111
11111100000001000000011111111111111111111111111111111
11111100000011000000011111111111111111111111111111111
11111100000010000000011111111111111111111111111111111
11111100000010000000011111111111111111111111111111111
11111100000010000000011111111111111111111111111111111
11111100000010000000011111111111111111111111111111111
11111100000010000000011111111111111111111111111111111
11111100000010000000011111111111111111111111111111111
11111100000000000000011111111111111111111111111111111
11111100000000000000011111111111111111111111111111111
11111100000000000000000011111111111111111111111111111
11111100000000000000000011111111111111111111111111111
11111100000000000000000011111111111111111111111111111
11111100000000000000000011111111111111111111111111111
11111100000000000000000011111111111111111111111111111
11111100000000000000000011111111111111111111111111111
11111100000000000000000011111111111111111111111111111
11111100000000000000000011111111111111111111111111111
11111111111111110011111111111111111111111111111111111
11111111111111110011111111111111111111111111111111111
11111111111111110011111111111111111111111111111111111
11111111111111110000000111111111111111111111111111111
11111111100000000000000011111111111111111111111111111
11111111100000000000000011111111111111111111111111111
11111111100000000000000011111111111111111111111111111
11111111100000000000000011111111111111111111111111111
11111111100000000000000011111111111111111111111111111
11111111100000000000000011111111111111111111111111111
11111111100000000000000011111111111111111111111111111
11111111111111110000000011111111111111111111111111111
11111111111111110011111111111111111111111111111111111
11111111111111110011111111111111111111111111111111111
11111100000000000011111110000000000000000000000000111
11111100000000000000000000000000000000000000000000001
11111100000000000000000000000000000000000000000000001
11111100000000000000000000000000000000000000000000001
11111100000000000000000000000000000000000000000000001
11111100000000000000000000000000000000000000000000001
11111100000000000000000000000000000000000000000000001
11111100000000000000000000000000000000000000000000001
11111100000000000000000000000000000000000000000000001
11111100000000000000011110000000000000000000000001111
11111100000000000000011110000000000000000000000001111
11111100000000000000011110000000000000000000000001111
11111100000000000000000000000000000000000000000000001
11111100000000000000000000000000000000000000000000001
11111100000000000000000000000000000000000000000000001
11111100000000000000000000000000000000000000000000001
11111100000000000000000000000000000000000000000000001
11111100000000000000000000000000000000000000000000001
11111100000000000000000000000000000000000000000000001
11111100000000000000000000000000000000000000000000001
11111100000000000000011110000000000000000000000001111
11111100000000000000011110000000000000000000000001111
11111100000000000000011110000000000000000000000001111
11111100000000000000000000000000000000000000000000001
11111100000001111111100000000000000000000000000000001
11111100000011111111111000000000000000000000000000001
11111100001111111111111100000000000000000000000000001
11111100001111111111111110000000000000000000000000001
11111100011111111111111110000000000000000000000000001
11111100011111111111111110000000110000000000000000001
11111100011111111111111110000001110000000000000000001
11111111111111111111111110000001111000000001111111111
11111111111111111111111110000011111000000001111111111
11111111111111111111111110000011111000000001111111111
11111111111111111111111110000011111000000001111111111
11111111111111111111111111111111111111111111111111111
11111111111111111111111111111111111111111111111111111
11111111111111111111111111111111111111111111111111111
11111111111111111111111111111111111111111111111111111
11111111111111111111111111111111111111111111111111111
11111111111111111111111111111111111111111111111111111
11111111111111111111111111111111111111111111111111111
11111111111111111111111111111111111111111111111111111

