40,48,0.8,
0000001111000000000000111111111111111111
0000000000000000000000000000000000000111
0000000000000000000000000000000000000000
0000000000000000000000000000000000000000
0000000111000000000001110000000000000000
0000000111000000000001110000000000000000
0000000000000000000000000000000000000000
0000000000000000000000000000000000000000
0000000000000000000000000000000000000000
0000000000000000000000000000000000000000
0000000111000000000001110000000000000000
0000000111000000000001110000000000000000
1111111111000000000000000000000000000000
1111111111000000000000000000000000000000
1111111111111100000000000000000000000000
1111111111111111111111110000000000000000
1111111111111111111111110000000000000000
1111111111111111111111110000000000000000
1111111111111111111111110000000000000000
1111111111111111111111110000000000000000
1111111111111111111111110000000000000000
1111111111111111111111110000000000000000
1111111111111111111000000000000000000000
1111111111111111111000000000000000000000
1111111111111111111000000000000000000000
1111111111111111111000000000000000000000
1111111111111111111111100000000000000000
1111111111111111111111100000000000000000
1111111111111111111111100000000000000000
1111111111111111111111100000000000000000
1111111111111111111111100000000000000000
1111111111111111111111100000000000000000
1111111111111111111111100000000000000000
1111111111111111111111100000000000000000
1111111111111111100000000000000000000000
1111111111111111100000000000000000000000
1111111111000000000001100000000000000000
0000000111000000000001100000000000000000
0000000000000000000001100000000000000000
0000000000000000000000000000000000000000
0000000000000000000000000000000000000000
0000000000000000000000000000000000000000
0000000110000000000011100000000000000000
0000000110000000000011100000000000000000
0000000000000000000011100000000000000000
0000000000000000000000000000000000000000
0000000000000000000000000000000000000000
0000000100000000100000000000000000000000

