69,75,0.8,
111111111111111100000001111111111111111111111111111111111111111111111
111111111111111100000001111111111111111111111111111111111111111111111
111111111111111100000001111111111111111111111111111111111111111111111
111111111111111100000001111111111111111111111111111111111111111111111
111111111111111100010001111111111111111111111111111111111111111111111
111111111111111100010000111111111111111111111111111111111111111111111
111111111111111100110000111111111111111111111111111111111111111111111
111111111111111100110000111111111111111111111111111111111111111111111
111111111111111100110001111111111111111111111111111111111111111111111
111111111111111100000001111111111111111111111111111111111111111111111
111111111111111100000000111111111111111111111111111111111111111111111
111111111111111100000000111111111111111111111111111111111111111111111
111111111111111100000000111111111111111111111111111111111111111111111
111111111111111100000000111111111111111111111111111111111111111111111
111111111111111111111011111111111111111111111111111111111111111111111
111111111111111111111011111111111111111111111111111111111111111111111
111111111111111111000000111111111111111111111111111111111111111111111
111111111111111111000000111111111111111111111111111111111111111111111
111111111111111111000000111111111111111111111111111111111111111111111
111111111111111111110000111111111111111111111111111111111111111111111
111111111111111111111011111111111111111111111111111111111111111111111
111111111111111100000011110000000000001111111111111111111111111111111
111111111111111100000000000000000000000000000000000001111111111111111
000000000111111100000000000000000000000000000000000000000000000000000
000111000111111100000000000000000000000000000000000000000000000000000
000111000111111100000001110000000000011100000000000000001111000011100
000000000111111100000001110000000000011100000000000000001111000011100
000000000111111100000000000000000000000000000000000000001111000011100
000000000111111100000000000000000000000000000000000000000000000000000
000000000111111100000000000000000000000000000000000000000000000000000
000111000111111100000000000000000000000000000000000000000000000000000
000111000111111100000001110000000000011100000000000000001111000011100
000000000111111100000001110000000000011100000000000000001111000011100
000000000111111111111111110000000000000000000000000000001111000011100
000000000111111111111111110000000000000000000000000000001111000011100
000000000111111111111111111111000000000000000000000000000000000011100
000111000111111111111111111111111111111100000000000000000000000000000
000111000111111111111111111111111111111100000000000000000000000000000
000000000111111111111111111111111111111100000000000000001110000011100
000000000111111111111111111111111111111100000000000000001110000011100
000000000111111111111111111111111111111100000000000000001110000011100
000111000111111111111111111111111111111100000000000000000000000011100
000000000111111111111111111111111111111100000000000000000000000000000
000000000000000000000000000000000000000000000000000000000000000000000
000000000000000000000000000000000000000000000000000000000000000000000
000000000000000000000000000000000000000000000000000000000000000000000
000111000000000000000000000000000000000000000000000000000000000000000
000111000111111111111111111111111111111000000000000000000000000000000
000000000111111111111111111111111111111000000000000000000000000000000
000000000111111111111111111111111111111000000000000000000000000000000
000000000111111111111111111111111111111000000000000000001111111111111
000111000111111111111111111111111111111000000000000000001111111111111
000111000111111111111111111111111111111000000000000000001111111111111
000000000111111111111111111111111111111000000000000000001111111111111
000000000111111111111111111111111111111000000000000000001111111111111
000000000111111111111111111111111000000000000000000000001111111111111
000111000111111111111111111111111000000000000000000000001111111111111
000111000111111111111111110000000000011000000000000000001111111111111
000111000111111100000001110000000000011000000000000000001111111111111
000000000111111100000000000000000000011000000000000000001111111111111
000000000111111100000000000000000000000000000000000000001111111111111
000000000111111100000000000000000000000000000000000000001111111111111
000000000111111100000000000000000000000000000000000000001111111111111
000110000111111100000001100000000000111000000000000000001111111111111
000000000111111100000001100000000000111000000000000000001111111111111
000000000111111100000000000000000000111000000000000000001111111111111
111111111111111100000000000000000000000000000000000000001111111111111
111111111111111100000000000000000000000000000000000000001111111111111
111111111111111100000001000000001000000000000000000000001111111111111
111111111111111111111111111111111111111111111111111111111111111111111
111111111111111111111111111111111111111111111111111111111111111111111
111111111111111111111111111111111111111111111111111111111111111111111
111111111111111111111111111111111111111111111111111111111111111111111
111111111111111111111111111111111111111111111111111111111111111111111
111111111111111111111111111111111111111111111111111111111111111111111

