9,12,
000000000
000000000
000000000
001111000
000000000
000000000
000200000
000000000
000000000
001111000
000000000
000000000
------
map of 9x12 cells
for total surface 7 x 9 m
each cell 1m

