14,18,
00000000000000
00000000000000
00000000000000
00000000000000
00001111110000
00000000000000
00000000000000
00000000000000
00000000000000
00020000010000
00000000010000
00000000010000
00000000010000
00000000010000
00000000010000
00000000000000
00000000000000
00000000000000
------
map of 14x18 cells
for total surface 7 x 9 m
each cell 1m

