140,94,
11111111111111111111111111111111111111111111111111111111111111111111111111111111111111111111111111111111111111111111111111111111111111111111
11111111111111111111100000001100000001111111111100000011000000011111111111111111111111111111111111111111111111111111111111111111111111111111
11111111111111111111100000001100000001111111111100000011000000011111111111111111111111111111111111111111111111111111111111111111111111111111
11111111111111111111100000001100000001100000011100000011000000011111111111111111111111111111111111111111111111111111111111111111111111111111
11111111111111111111100000001100000000000000000000000011000000011111111111111111111111111111111111111111111111111111111111111111111111111111
11111111111111111111100000001100000000000000000000000011000000011111111111111111111111111111111111111111111111111111111111111111111111111111
11111111111111111111100000001100000001100000001100000011000000011111111111111111111111111111111111111111111111111111111111111111111111111111
11111111111111111111100000000000000001100000011100000000000000011111111111111111111111111111111111111111111111111111111111111111111111111111
11111111111111111111100000000000000001110000011100000000000000011111111111111111111111111111111111111111111111111111111111111111111111111111
11111111111111111111100000001100000001111001111100000011000000011111111111111111111111111111111111111111111111111111111111111111111111111111
11111111111111111111111110111111111111111001111111110011110011111111111111111111111111111111111111111111111111111111111111111111111111111111
11111111111111111111111100001111111111111001111111110011110011111111111111111111111111111111111111111111111111111111111111111111111111111111
11111111111111111111100000000000000000010000110000000011000000011111111111111111111111111111111111111111111111111111111111111111111111111111
11111111111111111111100000001100000000010000110000000011000000011111111111111111111111111111111111111111111111111111111111111111111111111111
11111111111111111111100000001100000000010000110000000011000000011111111111111111111111111111111111111111111111111111111111111111111111111111
11111111111111111111100000001100000000000000000000000011000000011111111111111111111111111111111111111111100000000011111111111110000000001111
11111111111111111111100000001100000000000000000000000011000000011111111111111111111111111111111111111111100000000011111111111110000000001111
11111111111111111111100000001100000000010000110000000011000000011111111111111111111111111111111111111111100000000011111111111110000000001111
11111111111111111111100000001100000000010000110000000010000000011111111111111111111111111111111111111111100000000011000000000010000000001111
11111111111111111111100000001100000000010000110000000000000000011111111111111111111111111111111111111111100000000011000000000010000000001111
11111111111111111111111111111111110111111101111111111111111111111111111111111111111111111111111111111111100000000011000000000010000000001111
11111111111111111111111111111111110111111101111111111111111111111111111111111111111111111111111111111111100000000011000000000010000000001111
10000000110000000000100000000000000001111101111000000011000000011111111111100000011000000111111111111111100000000011000000000010000000001111
10000000110000000000000000000000000001111001111000000000000000011111111111100000011000000111111111111111100000000000000000000000000000001111
10000000110000000000100000000000000001110000011000000010000000011110000011100000011000000111000001111111111111111111000000000011111111111111
10000000110000000000100000000000000000000000000000000011000000011100000011100000011000000010000000111111111111111111000000000011111111111111
10000000110000000000100000000000000001110000011000000011000000011100000000000000011000000000000000111111111111111111000000000011111111111111
10000000110000000000100000000000000001110000111000000011000000011100000011100000011000000110000000111111111111111111000000000011111111111111
10000000110000000000100000000000000001111001111000000011000000011100000011100000011000000110000000111111111111111111000000000011111111111111
10000000110000000000100000000000000001111101111000000011000000011110000111100000011000000111000011111111111111111111000000000011111111111111
10000000000000000000111111111111111111111101111111111111000000011111101111100000011000000111110111111111111111111111000000000011111111111111
10011111111111101111111111111111111111111101111111111111111011111111101111111101111110111111110111111111111111111111000000000111111111111111
10011111111111101111100000000110000000000000000000000111111011111111101111111001111110111111110111111111111111111111000000000111111111111111
10000000000000000000100000000110000000000000000000000110000000011000000000100000000000001100000000111111111111111100000000000001111111111111
10000011000001100000000000000110000000000000000000000110000000011000000000100000000000001100000000111111111111111000000000000000011111111111
10000011000001100000100000000110000000000000000000000110000000011000000000100000000000001100000000111111111111100000000000000000001111111111
10000011000001100000100000000110000000000000000000000110000000000000000000100000000000001100000000111111111111000000000000000000000111111111
10000011000001100000100000000110000000000000000000000110000000011000000000100000000000001100000000111111111110000000000000000000000011111111
11111111000011100000100000000110000000000000000000000110000000011000000000100000000000001100000000111111111100000000000000000000000001111111
11111111110111100000100000000110000000000000000000000110000000011000000000100000000000001100000000111111111100000000000000000000000000111111
11111111111111111111100000000110000000000000000000000110000000011000000000100000000000001100000000111111111000000000000000000000000000111111
11111111111111111111100000000110000000000000000000000110000000011111101111111111101111111111110111111111111000000000000000000000000000011111
11111111111111100000111100111110000000000000000000000111111111111000000000000000000000000000000000110000000000000000000000000000000000000001
11111111111111100000111100111110000000000000000000000111111111111000000000000000000000000000000000110000000000000000000000000000000000000001
11111111111111100000100000000110000000000000000000000110000000011000000000000000000000000000000000110000000000000000000000000000000000000001
11111111111111100000100000000110000000000000000000000110000000011000000000000000000000000000000000000000000000000000000000000000000000000001
11111111111111100000100000000100000000000000000000000110000000000000000000000000000000000000000000000000000000000000000000000000000000000001
11111111111111100000000000000000000000000000000000000000000000000000000000000000000000000000000000000000000000000000000000000000000000000001
11111111111111100000100000000110000000000000000000000110000000011000000000000000000000000000000000000000000000000000000000000000000000000001
11111111111111100000100000000110000000000000000000000110000000011000000000000000000000000000000000010000000000000000000000000000000000000001
11111111111111100000111100111110000000000000000000000111111111111000000000000000000000000000000000110000000000000000000000000000000000000001
11111111111111100000111100111110000000000000000000000111111111111000000000000000000000000000000000110000000000000000000000000000000000000001
11111111111111100000100000000110000000000000000000000110000000011111001111111111101111111111110111111111110000000000000000000000000000011111
11111111111111111111100000000110000000000000000000000110000000011111101111111111101111111111110111111111111000000000000000000000000000111111
10000000000001111111100000000110000000000000000000000110000000011000000000100000000000001100000000010000111000000000000000000000000000111111
10000000000001111111100000000110000000000000000000000110000000011000000000000000000000001100000000000000111100000000000000000000000001111111
10000000000001111111100000000110000000000000000000000110000000011000000000100000000000001100000000110000111110000000000000000000000011111111
10000000000001111111100000000110000000000000000000000110000000000000000000100000000000001100000000111001111111000000000000000000000011111111
10000000000001111111100000000110000000000000000000000110000000011000000000100000000000000000000000111111111111000000000000000000001111111111
10000000000001111111100000000110000000000000000000000110000000011000000000100000000000001100000000110000111111110000000000000000011111111111
10000000000001111111100000000110000000000000000000000110000000011000000000100000000000001100000000110000111111111100000000000000111111111111
11011111111101111111100000000110000000000000000000000110000000011001111111110111111111011111111110110000111111111110000000000011111111111111
11011111111101111111100000000111111111111000000000000111111000111101111111110111111111011111111110110000111111111111000000000111111111111111
10000000001000000000000000000111111111111101111111111111111101111000000000000110000000001100000000110000111111111111000000000011111111111111
10000000001000000000111111101110000001111101111000000000011000011000000000000110000000001100000000110000111111111111000000000011111111111111
10000000001000000000111111101110000001111001111000000000001000011000000000000110000000001100000000110000110000000011000000000010000000001111
10000000000000000000100000000110000001110000111000000000001000011000000000000110000000001100000000110000110000000011000000000010000000001111
10000000000000000000100000000110000001110000011000000000001000011000000000000110000000001100000000111011110000000011000000000010000000001111
10000000001000000000100000000110000000000000000000000000000000011000000000000110000000001100000000111001110000000011000000000010000000001111
10000000001000000000100000000110000001110000011000000000001000011000000000000110000000001100000000110000110000000000000000000000000000001111
10000000001000000000000000000110000001110000111000000000001000011000000000000000000000000000000000000000110000000000000000000000000000001111
10000000001000000000000000000110000001111001111000000000001000011000000000000110000000001100000000110000110000000000000000000000000000001111
11111111111111111111111011111111111011111001111110111111111101111111111111111111111111111111111111111111110000000011000000000010000000001111
11111111111111111111111011111111111011111001111110111111111101111111111111111111111111111111111111111111110000000011000000000010000000001111
11111111111111111111100000001100000001000000001100000000000000011111111111111111111111111111111111111111110000000011000000000010000000001111
11111111111111111111100000000000000001000000001100000000000000011111111111111111111111111111111111111111110000000011000000000010000000001111
11111111111111111111100000001100000001000000001100000000000000011111111111111111111111111111111111111111110000000011000000000010000000001111
11111111111111111111100000001100000001000000001100000000000000011111111111111111111111111111111111111111111111111111111111111111111111111111
11111111111111111111100000001100000001000000001100000000000000011111111111111111111111111111111111111111111111111111111111111111111111111111
11111111111111111111100000001100000001000000001100000000000000011111111111111111111111111111111111111111111111111111111111111111111111111111
11111111111111111111100000001100000001000000001100000000000000011111111111111111111111111111111111111111111111111111111111111111111111111111
11111111111111111111100000001100000001000000001100000000000000011111111111111111111111111111111111111111111111111111111111111111111111111111
11111111111111111111110011111111101111111101111100111111111101111111111111111111111111111111111111111111111111111111111111111111111111111111
11111111111111111111110011111111101111111101111101111111111100111111111111111111111111111111111111111111111111111111111111111111111111111111
11111111111111111111100000001100000001111101111100000011000000011111111111111111111111111111111111111111111111111111111111111111111111111111
11111111111111111111100000001100000001110000111100000011000000011111111111111111111111111111111111111111111111111111111111111111111111111111
11111111111111111111100000001100000001100000011100000011000000011111111111111111111111111111111111111111111111111111111111111111111111111111
11111111111111111111100000000000000000000000000000000011000000011111111111111111111111111111111111111111111111111111111111111111111111111111
11111111111111111111100000000000000001100000001100000000000000011111111111111111111111111111111111111111111111111111111111111111111111111111
11111111111111111111100000001100000001100000011100000011000000011111111111111111111111111111111111111111111111111111111111111111111111111111
11111111111111111111100000001100000001110000111100000011000000011111111111111111111111111111111111111111111111111111111111111111111111111111
11111111111111111111100000001100000001111001111100000011000000011111111111111111111111111111111111111111111111111111111111111111111111111111
11111111111111111111100000001100000001111111111100000011000000011111111111111111111111111111111111111111111111111111111111111111111111111111
11111111111111111111111111111111111111111111111111111111111111111111111111111111111111111111111111111111111111111111111111111111111111111111

