106,48,
1111111111111111111111111100000000000000000000000000000000000000000000000000000111000010000011100111000001
0000001100001000001000001100000000000000000000000000000000000000000000000000000111000010000010000010000000
0000001100001000001000001100000000000000000000000000000000000000000000000000000111000010000010000010000000
0000001100001000001000001100000000000000000000000000000000000000000000000000000111000010000010000010000000
0000001100001000001000001100000000000000000000000000000000000000000000000000000111000010000010000010000000
0000011100001000001000001111111111111111111111111100000011111111111111111111111111000010111110111110111111
0000011111101111101111101111111111111111111111111100000011111111111111111111111111011110000010111110111111
0000000000000000000000000000100110011000011000001100000011000000110000001100000011000000000000000000111111
1111110000000000000000011000100000011000011000001100000011000000110000001100000011000101111111101000111111
0000010011101111101111011100100000011000011000001100000011000000110000001100000010000101111111101100000000
0000010011000110001100011100100000011000011000001100000011000000110000001100000011000100000000001100110000
0000010011000110001100011100100000011000011000001100000011000000110000001100000011000100000000001100110000
0000010011000110001100011100111111011011111011111100000011111110111111101111111011000100000000001100110000
0000010011000110001100011100000000000000000000000000000000000000000000000000000000000100000000001100110000
0000000011000110001100011100000000000000000000000000000000000000000000000000000000000100000000001100111111
1111110011000110001100011111111000101111111101111100000011110111111111110111111110111111111111111100111111
1111110011111111111111111111111000101111111101111100000011110000000001110111111110000000001100001100111111
0000010011111111111111111100001000100000011001111100000011110000000001110000000000000000001000001100000000
0000010011000001000001001100001000100000011001111100000011110000000001110000000000000000001100001100011000
0000010001000001000001001100001000100000011001111100000011110000000001110000000000000000001100000000001111
0000010001000001000001001100001000111111111111111100000011111111111111110000000000000000001100000000011111
0000010001000001000001001100001000110000111111111100000011111111111111110000000000000000001111111100011111
0000000011000001000001001100001000110000100000000000000000000000000000000000000000000000001100001100011111
1111110011111101111101101101111000110000100000001100000010000000000000110000000000000000001100001100011111
0000000000000000000000000000000000110000100000001100000010000000000000110000000000000000001100001100011111
0000010000000000000000000000000000110000100000001100000010000000000000110000000000000000001100001100011111
0000011111101111101111011111101100111000100000001100000010000000000000110000000000000000001111100000011111
0000011000001000001000011000001100000000100000001100000010000000000000110000000000000000001111111100111111
0000001000001000001000011000001100011000100000001100000010000000000000110000000000000000001100000000000000
0000001000001000001000011000001100011000100000001100000010000000000000110000000000000000001000001100110000
0000001000001000001000011000001111011000100000001100000011111000000000110000000000000000001100001100110000
0000001000001000001000011000001111011111111111111100000011111000000000110000000011111111111111111100111111
1111111111111111111111111111111111011111111111111100000011111111111111111111111111111111111111111100111111
1111111111111111111111111111111111010000001111111100000000000011111111111111111111111111111111111100111111
1111111111111000000000000000000000000000000000000000000000000000000000000000000000000000000000000000000001
1111111111111000000000000000110000000000000000000000000000000000000000000000000000000000000000000000000001
1111111111111000000000000000110011011110101110111000000000000000000000000000000000000000000000000000000001
1111111111111000000000000000110011111111111111111000000000000000000000000000000000000000000000000000000001
1111111111110000000000000000110011111111111111110000000000000000000000000000000000000000000000000000000001
1111111111110000000000000000110011111111111111110000000000000000000000000000000000000000000000000000000001
1111111111110000000000000000110011111111111111110000000000000000000000000000000000000000000000000000000001
1111111111110000000000000000110011111111111111110000000000000000000000000000000000000000000000000000000001
1111111111110000000000000000110011111111111111111000000000000000000000000000000000000000000000000000000001
1111111111110000000000000000110011111111111111111000000000000000000000000000000000000000000000000000000001
1111111111111000000000000000110011111111111111111000000000000000000000000000000000000000000000000000000001
1111111111111000000000000000110011111111111111111000000000000000000000000000000000000000000000000000000001
1111111111111000000000000000110011111111111111111000000000000000000000000000000000000000000000000000000001
1111111111111000000000000000000011111111111111111111111111111111111111111111111111111111111111111111111111

