10,10,
0000000000
0000000000
0000000000
0000200000
0000000000
0000000000
0000000000
0000000000
0011111100
0000000000
