12,12,
000000000000
000000000000
000000000000
000000000000
000002000000
000000000000
000000000000
000000000000
000000000000
000000000000
001111111100
000000000000
