17,17,
00000000000000000
00000000000000000
00100000000000000
00100000000000000
00100000000000000
00100000000000000
00100000000000000
00100000000000000
00100000200000000
00100000000000000
00100000000000000
00100000000000000
00100000000000000
00000000000000000
00011111111111000
00000000000000000
00000000000000000
