12,12,
000000000000
000000000000
001000000000
001000000000
001000000000
001000000000
001000200000
001000000000
000000000000
000111111000
000000000000
000000000000
