15,15,
000000000000000
000000000000000
001000000000000
001000000000000
001000000000000
001000000000000
001000000000000
001000020000000
001000000000000
001000000000000
001000000000000
000000000000000
000111111111000
000000000000000
000000000000000
