10,10,
0000000000
0000000000
0000000000
0100000000
0100000000
0100020000
0100000000
0000000000
0011111100
0000000000
