17,17,
00000000000000000
00011111111111000
00000000000000000
00000000000000100
00000000000000100
00000000000000100
00000000000000100
00000000000000100
00000002000000100
00000000000000100
00000000000000100
00000000000000100
00000000000000100
00000000000000100
00000000000000000
00011111111111000
00000000000000000
