10,10,
0000000000
0011111100
0000000000
0000000010
0000000010
0000200010
0000000010
0000000000
0011111100
0000000000
