15,15,
000000000000000
000111111111000
000000000000000
000000000000100
000000000000100
000000000000100
000000000000100
000002000000100
000000000000100
000000000000100
000000000000100
000000000000100
000000000000000
000111111111000
000000000000000
