12,12,
000000000000
001111111100
000000000000
000000000010
000000000010
000000000010
000002000010
000000000010
000000000010
000000000000
001111111100
000000000000
