20,20,
00000000000000000000
00000000000000000000
00000000000000000000
00000000000000000000
00000000000000000000
00001111111111110000
00000000000000000100
00000000000000000100
00000000000000000100
00000000200000000100
00000000000000000100
00000000000000000100
00000000000000000100
00000000000000000100
00000000000000000000
00000000000000000000
00000000000000000000
00000000000000000000
00000000000000000000
00000000000000000000
