12,12,
000000000000
001111111100
000000000000
010000000010
010000000010
010000000010
010002000010
010000000010
010000000010
000000000000
001111111100
000000000000
