10,10,
0000000000
0011111100
0000000000
0100000010
0100000010
0100200010
0100000010
0000000000
0011111100
0000000000