15,15,
000000000000000
000111111111000
000000000000000
001000000000100
001000000000100
001000000000100
001000000000100
001000200000100
001000000000100
001000000000100
001000000000100
001000000000100
000000000000000
000111111111000
000000000000000
