10,10,
0000000000
0000000000
1111111000
0000000000
0000000000
0000000000
0000000000
0000000000
0000000000
0000000002
