10,10,
0000000000
0000000000
1111001111
0000000000
0000000000
0000000000
0000000000
0000000000
0000000000
0000000200
