14,6,
00011111111111
00010000101100
00000000000000
00011111101100
00011111101100
00000200000000
