20,9,
00011111111111111111
00011111111111111111
00010000101100000001
00010000000000000000
00000000000000000000
00011111101100000001
00011111101100000001
00000000000000000000
00000000000000200000
