40,44,
1111111111111100000000011111111111111111
1111111111111100000000011111111111111111
1111111111111100000000011111111111111111
1110000000001100000000011111111111111111
1100000000000100000000011111111111111111
1100000000000100000000011111111111111111
1100000000000100000000011111111111111111
1100000000000100000000011111111111111111
1100000000000100000000011111111111111111
1100000000000100000000011111111111111111
1100000000000100000000011111111111111111
1100000000000100000000011111111111111111
0000000000000000000000000000000000000000
0000000000000000000000000000000000000000
0000000000000000000000000000000000000000
0000000000000000000000000000000000000000
0000000000000000000000000000000000000000
0000000000000000000000000000000000000000
0000000000000000000000000000000000000000
0000000000000000000000000000000000000000
0000000000000000000000000000000000000000
0000000000000000000000000000000000000000
0000000000000000000000000000000000000000
0000000000000000000000000000000000000000
0000000000000000000000000000000000000000
0000000000000000000000000000000000000000
0000000000000000000000000000000000000000
0000000000000000000000000000000000000000
0000000000000000000000000000000000000000
0000000000000000000000000000000000000000
0000000000000000000000000000000000000000
0000000000000000000000000000000000000000
0000000000000000000000000000000000000000
0000000000000000000000000000000000000000
0000000000000000000000000000000000000000
1111111111111111000000111111111111111111
1111111111111111000000111111111111111111
1111111111111111000000111111111111111111
1111111111111111000000111111111111111111
0000000000000000000000000000000000000000
0000000000000000000000000000000000000000
0000000000000000000000000000000000000000
0000000000000000000000000000000000000000
0000000000000000000000000000000000000000
