30,11,
000111111111111111111111111111
000111111111111111111111111111
000100001011000000011000000011
000100000000000000000000000000
000100000000000000000000000000
000100000000000000000000000000
000000000000000000000000000000
000111111011000000011000000011
000111111011000000011000000011
000000000000000000000000000000
000000000000002000000000000000
