50,50,
00000000000000000000000000000000000000000000000000
00000000000000000000000000000000000000000000000000
00000000000000000000000000000000000000000000000000
00000000000000011111001000000000000000000000000000
00000000000000000000000001001111110100011110111100
00000000000000000000000000000000000000000000000000
00000000000000000000000000000000000000000000000000
00000000000000000000000000000000000000000000000000
00000010000000000000000000000000000000000000000000
00000010000000000000000000000000000000000000000000
00000010000000000000000000000000000000000000000000
00000010000000000001111111111110111000000000000000
00000010000000000010000000000000000101100000000000
00000001000000000000000000000000000000011100000000
00000001000000000000000000000000000000000110000000
00000001000000000000000000000000000000000011000000
00000000000000000000000000000000000000000001000000
00000000000000000000000000000000000000000001000000
00000001000000000000000000000000000000000001100000
00000001000000000000001111111000000000000000100000
00000001000000000000000000000000000000000000100000
00000000000010000001000000000100000000000000100000
00000001000010000001000000000100000000000000100000
00000001000010000001000000000100000000000000100000
00000001000000000001000020000100000000000000000000
00000001000010000001000000000100000000000000100000
00000001000010000001000000000000000000000000100000
00000001000000000001000000000000000000000000100000
00000000000010000000011111111000000000000000100000
00000000000000000000110000000000000000000001100000
00000001000000000000000000000000000000000001000000
00000000000000000000000000000000000000000001000000
00000001000000000000011110111010011100000011000000
00000001000000000000000000000000000000000010000000
00000001000010000000000000000000000000000110000000
00000001000010000000000000000000000000000100000000
00000001000000000000000000000000000000001100010000
00000000000000000100000000000000000000011000010000
00000000000010000110000000000000000000110000110000
00010000000000000011000000000000000000100000100000
00010000000010000001100000000100011000010011100000
00001000000000000000001101000000000000011110000000
00001000000010000000000000000000000000000000000000
00000000000010000000000000000000000000000000000000
00000100000010000000000000000000000000000000000000
00000110000000000110000000000000000000000000000000
00000011100000000011101010000000000001100000000000
00000000000000000000000000010101010111000000000000
00000000000000000000000000000000000000000000000000
00000000000000000000000000000000000000000000000000

